111111111111111
1P00110000001C1
100001000000111
10000000C000001
100000000000001
100000111111111
1000000000000E1
111111111111111