111111111111111
1P0011000000001
10000100000C001
10000100C000001
100000000000001
111111111111111
1000000000000E1
111111111111111