1111111111111111111111111111111111111111111111111111111111
1P000000000000000000111110000000C00000C00011110000000000E1
1111111111111000000000000000111111111110000000000111110001
1000000000000000000000000000000000C00000000000000000000001
100000000C000001111111111111111111111111111110000000000001
10C00000000000000000000000000000000000000000000000000C0001
1000000000000000000000000000000000000001111111111111111111
1111111111111111111111000000C00000000000000000000000000001
1000000C00000000000000000111111111111100000000C00000000001
1111111111111111111111111111111111111111111111111111111111