11111111111
100C0000001
100111000C1
10011000001
1P1E0000001
11111111111