11111111111111111
1E000000000000001
11111111101111001
1000001P10100C001
10000000101001111
100C00000000000C1
11111111111111111