1111111111111111111
1P0010C000000000001
10001111110000000C1
1000000000000000001
1001111111111110001
1C01E00000000C00001
1111111111111111111