11111111111111111111111111111111
1E100000000000000000C00000000001
10101111111000000100000000001101
10101C00000100000100000011111101
1000100011000000010000000000C1P1
11111111111111111111111111111111