11111111111111111111111111111
1P000000000000000000000000001
11111111111111111111111111101
110000000000C0000000000000001
11011111111111111111111111111
11000C00000000000000000000011
11111111111111111111111111011
11111111111111111111111111011
11111111111111111111111111011
10000000000000000000000000011
100000000000000C0000000000011
10000110001100011000110001111
101100110011001100110011C0011
10011111111111111111111111111
100000000000000000000000000E1
11111111111111111111111111111