111111111111111111111111111111111111
1P000000000000000C000000000000000011
111111111111111111111111111111111011
11000000000000000C000000000000011011
110111111111111111111111111111011011
11011000000000000C000000000011011011
110110111111111111111111111011011011
11011011000000000C000000011011011011
110110110111111111111111011011011011
110110110110000000E11111011011011011
110110110110000000000000011011011011
110110110111111111111111111011011011
11011011000000000C000000000011011011
110110111111111111111111111111011011
11011000000000000C000000000000011011
110111111111111111111111111111111011
11000000000000000C000000000000000011
111111111111111111111111111111111111