111111111
1X00C00E1
1PX000001
111111111