1111111111111111111
100000X0C0000X01111
1001111111000001111
10010000C0000P01111
1000000000000E01111
1X001111101100000C1
1111111111111111111