11111111111
100C000X001
100111000C1
10011000X01
1P1E0000001
11111111111